# Discworld
ANK = "countries/AnkhMorpork.txt"
QUI = "countries/Quirm.txt"
PSE = "countries/Pseudopolis.txt"
STO = "countries/StoLat.txt"
CHI = "countries/Chirm.txt"
IST = "countries/Istanzia.txt"
OMN = "countries/Omnia.txt"
BET = "countries/Betrek.txt"
USH = "countries/Ushistan.txt"
EPH = "countries/Ephebe.txt"
DJE = "countries/Djelibeybi.txt"
TSO = "countries/Tsort.txt"
KLA = "countries/Klatch.txt"
OCT = "countries/Octarinia.txt"
CHR = "countries/Chimeria.txt"
LAC = "countries/Lancre.txt"
SMA = "countries/SmarlBund.txt"
ASG = "countries/Asagravia.txt"
UBE = "countries/Ueberwald.txt"
KLT = "countries/Klatchistan.txt"
HER = "countries/Hersheba.txt"
YMI = "countries/Ymitury.txt"
HOW = "countries/Howandaland.txt"
URA = "countries/Urabewe.txt"
SAP = "countries/Sapina.txt"
URT = "countries/Urt.txt"
TET = "countries/Tetse.txt"
TEZ = "countries/TezumanEmpire.txt"
VAN = "countries/Vanglemesh.txt"
SUM = "countries/Sumtri.txt"
LLA = "countries/Llamedos.txt"
HRG = "countries/Hergen.txt"
GON = "countries/Gonim.txt"
ECA = "countries/Ecalpon.txt"
KRU = "countries/Krull.txt"
AGA = "countries/AgateanEmpire.txt"
FOU = "countries/Fourecks.txt"
NOT = "countries/NoThingfjord.txt"
EGE = "countries/Egene.txt"
SCH = "countries/Scherbenwald.txt"
KHN = "countries/Khanli.txt"
FAR = "countries/Farferee.txt"
MNT = "countries/Muntab.txt"
REH = "countries/Rehigreed.txt"
ORO = "countries/Orohai.txt"
BOR = "countries/Borogravia.txt"
BRN = "countries/Brindisi.txt"
GNU = "countries/Genua.txt"
KYT = "countries/Kythia.txt"
VIU = "countries/VieuxRiver.txt"
ZLO = "countries/Zlobenia.txt"
DAL = "countries/Dalarcar.txt"
STU = "countries/StoLatUnion.txt"
EVE = "countries/EvilEmpire.txt"
ANE = "countries/AnkhianEmpire.txt"
TCH = "countries/TheChalk.txt"
SKU = "countries/Skund.txt"
OHU = "countries/Ohulan.txt"
FEL = "countries/Fellen.txt"
PAK = "countries/Pakein.txt"
VOJ = "countries/Vojania.txt"
GHA = "countries/Ghat.txt"

# Special countries..
REB = "countries/Rebels.txt"
PIR = "countries/Pirates.txt"
NAT = "countries/Natives.txt"

